OOOOOOOOOOOOOOOOOO
OSFFFFFFOFFFFFFFOO
OFOOOOOFOOOFOOOFOO
OFFFFFOFFFOFOFFFOO
OFOOOFOOOFOFOFOFOO
OFOFOFFFOFOFOFOFOO
OFFFOFOFOFOFFFOOOO
OFFFFFOFFFOFOFFFOO
OOOOOFOOOOOOOOOFOO
OFFFOFFFFFFFFFOFOO
OOOFFFOFOOOOOFOFOO
OFFFOFFFOFFFFFFFOO
OFOOOOOOOFOOOOOFOO
OFFFFFFFOFFFOFFFOO
OFOOOOOFOOOFOOOFOO
OFFFFFOFFFFFFFFFFO
OOOOOOOOOOOOOOOFGO
OOOOOOOOOOOOOOOOOO
