OOOOOOOOOOOOOOOOOO
OSFFFFOFFFFFOFFFOO
OFOFOFOOOFOFFFOFOO
OFFFOFFFFFOFOFOFOO
OFOFOOFOOOOFOFFOOO
OFOFFFFFFFOFOFFFOO
OFOOFFOFOFOFOOOFOO
OFFFOFOFOFOFFFOFOO
OFFFOFOFOOOOOFOFOO
OFFFOFOFFFFFFFOFOO
OFOFOFOFOOOOOOOFOO
OFOFFFOFFFFFFFOFOO
OFOOOOOOOOOFOFOFOO
OFOFFFFFOFFFOFFFOO
OFOOOFOFOFOOOOOFOO
OFFFFFOFFFFFFFFFFO
OOOOOOOOOOOOOOOFGO
OOOOOOOOOOOOOOOOOO
