OOOOOOOOOOOOOOOOOO
OSFFOFFFFFFFOFFFOO
OFOFOFOOFFOFOFOFOO
OFOFOFFFOFOFOFFFOO
OFOFOOOFOFFFOOOFOO
OFFFOFFFFFOFOFFFOO
OFOFOOFFOFFFOFOFOO
OFOFFFOFOFOFFFFFOO
OFOFOFOFOFOFFOOFOO
OFFFFFOFFFFFFFOFOO
OFOOOOOOOOOFOFOFOO
OFOFFFFFFFFFOFOFOO
OFOFOOOFOOOOFFOFOO
OFOFFFOFFFFFFFOFOO
OFFOOFOFOOOFFOOFOO
OFFFFFOFFFFFFFFFFO
OOOOOOOOOOOOOOOFGO
OOOOOOOOOOOOOOOOOO
