OOOOOOOOOOOOOOOOOO
OGFFFFFFFFOFFFFFOO
OFOFOOOOOFOFOOOFOO
OFFFOFFFFFFFOFFFOO
OOOFOFOOOOOOOFOFOO
OFFFFFFFFFFFFFOFOO
OFOOOOFOFOOOOOFFOO
OFFFFFFFFFFFOFFFOO
OFOOOOOOOFOOOFOOOO
OFFFFFFFOFFFFFOFOO
OOOOOFOFFOOFOFOFOO
OFFFOFOFFFFFFFOFOO
OOOFOFOOOFOOOOOFOO
OFFFOFFFFFOFFFFFOO
OFFOOOOOOFFOOOOFOO
OFFFFFFFFFFFFFFFFO
OOOOOOOOOOOOOOOFSO
OOOOOOOOOOOOOOOOOO
