OOOOOOOOOOOOOOOOOO
OSFFFFFFFFFFFFFFOO
OFOFOOOFOOOFOOOFOO
OFOFOFOFOFFFFFOFOO
OFOFOFOFOOOOOFOFOO
OFOFFFOFOFFFFFOFOO
OFOOOFOFOFOOOOOFOO
OFFFOFOFOFFFFFFFOO
OOOFOOOFOFOOOOOFOO
OFOFFFOFFFFFFFOFOO
OFOOFFOOOFOOOFOFOO
OFFFOFFFOFOFFFOFOO
OFOFOOOFOFOFOOOFOO
OFOFFFOFOFOFOFOFOO
OFOOOOOFOOOFOFOFOO
OFFFFFFFFFFFOFFFFO
OOOOOOOOOOOOOOOFGO
OOOOOOOOOOOOOOOOOO
