OOOOOOOOOOOOOOOOOOOOOOOOOOOO
OSFFFFFFFFFFFFFFFFFFFFFFFFFO
OFOOOOOOOOOOOOOOOOOOOOOOOOFO
OFOFFFFFFFFFFFFFFFFFFFFFFFFO
OFOFOOOOOOOOOOOOOOOOOOOOOOOO
OFOFFFFFFFFFFFFFFFFFFFFFFFFO
OFOOOOOOOOOOOOOOOOOOOOOOOOFO
OFOFFFFFFFFFFFFFFFFFFFFFFFFO
OFOFOOOOOOOOOOOOOOOOOOOOOOOO
OFOFFFFFFFFFFFFFFFFFFFFFFFFO
OFOOOOOOOOOOOOOOOOOOOOOOOOFO
OFOFFFFFFFFFFFFFFFFFFFFFFFFO
OFOFOOOOOOOOOOOOOOOOOOOOOOOO
OFOFFFFFFFFFFFFFFFFFFFFFFFFO
OFOOOOOOOOOOOOOOOOOOOOOOOOFO
OFOFFFFFFFFFFFFFFFFFFFFFFFFO
OFOFOOOOOOOOOOOOOOOOOOOOOOOO
OFOFFFFFFFFFFFFFFFFFFFFFFFFO
OFOOOOOOOOOOOOOOOOOOOOOOOOFO
OFOFFFFFFFFFFFFFFFFFFFFFFFFO
OFOOOOOOOOOOOOOOOOOOOOOOOOOO
OFOOOOOOOOOOOOOOOOOOOOOOOOOO
OFOOOOOOOOOOOOOOOOOOOOOOOOOO
OFOOOOOOOOOOOOOOOOOOOOOOOOOO
OFOOOOOOOOOOOOOOOOOOOOOOOOOO
OFOOOOOOOOOOOOOOOOOOOOOOOOOO
OFFFFFFFFFFFFFFFFFFFFFFFFFGO
OOOOOOOOOOOOOOOOOOOOOOOOOOOO
