OOOOOOOOOOOOOOOOOO
OSFFFFFMOFOFFMFFOO
OWOOOOOFOWOFOOOMOO
OFFFOFFFOFOFOFFFOO
OMOWOMOOOFOFOFOWOO
OFOMFFOFWFMFOFOFOO
OWOOOOOOOOOFOFOMOO
OFOFFFFFMFFMFFOFOO
OFOFOOOOOOOOOOOFOO
OFFWOFFFOMFFOFFWOO
OOOOOMOOOFOMFMOOOO
OFFFFFOFFFOWFFOFOO
OFOOOFOWOOOOOOOWOO
OFOMOFOFOFFMFFFFOO
OFOFOFOFOOOOOOOFOO
OFFFOMFFWMWFFMFFFO
OOOOOOOOOOOOOOOFGO
OOOOOOOOOOOOOOOOOO
