OOOOOOOOOOOOOOOOOO
OSWFFFFFOFFFFFFMOO
OFOFOWFMOOMFOFOFOO
OFOWOFFWFMMWOFFFOO
OFOFOFFFOOOOOFOOOO
OWFWOFMFFMOFWMWWOO
OOOMOMOOOMOFOOOMOO
OFOMOFOFMFOFFMOFOO
OFOFOOOFOOOOMFFFOO
OFOFMWFFOMFFFFOMOO
OFOOOMOFOOOFOMOFOO
OFFFOFOFOWFMOMOWOO
OMOFOFOMOFOFOWOWOO
OFOMFMOWOFOFOMFFOO
OFOFOOWFOFOOOOOFOO
OFMFFFWWOMWFMFFFFO
OOOOOOOOOOOOOOOFGO
OOOOOOOOOOOOOOOOOO
